000000000000000000000000000X000000000000
000000000000000000000000000X000000000000
000000000000000000000000000X000000000000
000000000000000000000000000X000000000000
00000V0000000000000000000000000000000000
000000000000000000000000000XXXXX000XXXXX
0000000000000000000000000000000000000000
0000000000000000000000000000000000000000
0000000000000000000000000000000000000000
0000000111111110000000000000000000000000
0000011122222210000000000000000000000000
0001121123443210000000000000000000000000
0001121122222210000000000000000000000000
0000011111111111100000000000000000000000
0000000000000012110000000000000000000000
0000000000000011221000000000000000000000
0000000000000001222100000000000000000000
0000000000000001232100000000000000000000
0000000000000001234321000000000000000000
0000000000000000123454321000000000000000
0000000000000000012345654321000000000000
0000000000000000001234543210000000000000
0000000000000000000123443210000000000000
0000111100000000000012332100000000000000
0112122211100000000001232100000000000000
0222222222100000000000121000000000000000
0233333332100000000000010000000000000000
0234444432110000000000000000000000000000
1234555432111000000000000000000000000000
1244565442111000000000000000000000000000
1234555434110000000000000000000000000000
023446443211000000000~~~~~~~~~0~~~~~~~~~
02333533321000000000~0000000000000000000
0222333322100000000~00000000000000000000
0111333311100000000~00000000000000000000
001222210000000000~000000000000000000000
000011100000000~~~~000000000000000000000
0000000000000000000000000000000000000000
000000000000000~000000000000000000000000
000000000000000~000000000000000000000000
