0000000000000X0000000000000X000000000000
000000000000X00000000000000X000000000000
00000000000X000000000000000X000000000000
0000000000X0000000000000000X000000000000
0000000000X00000000000000000000000000000
0000000000X0000000000000000XXXXX000XXXXX
0000000000X00000000000000000000000000000
0000XXXXXX00000XXXXX00X00000000000000000
000000000000000X000000X00000000000000000
000000000000000X000000X00000000000000000
000000000000000X000000X000000XXXXXXXX000
000000000000000X000000X000000X000000X000
00XXXXXXXXXXXXXX000000X000000X000000X000
00X0000000000000000000X000000X000000X000
00X0000000000000000000X000000X000000X000
00X0000000000000000000X000000X000000X000
00X0000000000000000000X00000000000000000
00X0000000000000000000X00000000000000000
00X0000000000000000000X00000000000000000
00X0000000000000000000X00000000000000000
00X0000000000000000000XXXXXXXXXX00000000
00X0000000000000000000000000000X00000000
00X0000000000000000000000000000X00000000
00X0000000000000000000000000000X00000000
00X0000000000000000000000000000X00000000
00XXXXXXXXXXXXXXXXXXXXXXXXXXXXXX00000000
0000000000000000000000000000000000000000
00XXXXXXXXXXXXXXX00000000000000000000000
00X0000000000000000000000000000000000000
00XXXXXXXXXXXXXXXX0000000XXXXXXXXXXXXXXX
0000000000000000000000000000000000000000
XXXXXXXXXXXXXXXXXXXXXXXX0000000000000000
0000000000000000000000000000000000000000
0000000000000000000000000000000000000000
0000000000000000000000000000000000000000
0000000000000000000000000000000000000000
0000000000000000000000000000000000000000
0000000000000000000000000000000000000000
0000000000000000000000000000000000000000
0000000000000000000000000000000000000000
